WWWWWWWWWWWWWWW
W.............W
W.P...........W
W.............W
W.WWWWWWWWWWW.W
W.W...........W
W.W...........W
W.W....B......W
W.W...........W
W.W...........W
W.W....G......W
W.W...........W
W.WWWWWWWWWWW.W
W.............W
WWWWWWWWWWWWWWW