WWWWWWWWWWWWWWW
W.............W
W.P..B....G...W
W.............W
W.WWWWWWWWWWW.W
W.............W
W.....X.......W
W.............W
W.WWWWWWWWWWW.W
W.............W
W....B....G...W
W.............W
W.....X.......W
W.............W
WWWWWWWWWWWWWWW