WWWWWWW
WP....W
W.WWW.W
W.B.G.W
W.WWW.W
W.....W
WWWWWWW