WWWWWWWWWWWWWWW
W.............W
W.P...........W
W.WWWWWWWWWWW.W
W.W...........W
W.W.G....B....W
W.W...........W
W.W.....X.....W
W.W...........W
W.WWWWWWWWWWW.W
W.............W
W.B....G......W
W.............W
W.....X.......W
WWWWWWWWWWWWWWW