WWWWWW
WP..BW
W.WW.W
W..G.W
WWWWWW